10
x1xxxx1xxx
277xxx1xxx
x5x3xx1xxx
xx315x1xxx
xxx5xx1xxx
x1xxxx1xxx
277xxx1xxx
x5x3xx1xxx
xx315x1xxx
xxx5xx1xxx