10
6xx7215xxx
1xxxxx3xx2
x36xxx1x2x
xx17x14x3x
xxxxxxxxxx
4xxx1xxx34
2xx94x4xxx
4x3xx9x56x
2xxxx2xxxx
xx234xxx26