10
6007215000
1000003002
0360001020
0017014030
0000000000
4000100034
2009404000
4030090560
2000020000
0023400026