8
20000030
60342000
00050000
00004020
10000000
20000000
01000130
00000000